{
  "2": "WM",
  "41": "WM",
  "3": "GM",
  "42": "GM",
  "10": "GM",
  "49": "GM",
  "11": "GM",
  "50": "GM",
  "12": "GM",
  "51": "GM",
  "13": "GM",
  "52": "GM"
}